SO	./ft_split_wspace.c
NO	./ft_split_wspace.c
EA	./ft_split_wspace.c
WE	./init_pars.c

F	255, 255, 255
C	255, 0, 10





1111		1111
100111111111100111111111
100000000000000000000001	   11111111111111111
10000000000000000000N001	   10000000000000001
100000000000000000000001	   10000000000000001
100000000111100000000001111111111000011111111111
1000000001  1000000000000000000000000011
1000000001111000000000000000000000000001
1000000000000000000000011111111111111111
100000000000000000000001
100000000001111110000001
100000101111	10000001
111111111111	11111111





tab = 4 space