SO	./ft_split_wspace.c
NO	./ft_split_wspace.c
EA	./ft_split_wspace.c
WE	./init.c

F	255, 255, 255
C	255, 0, 10

1111
1111