NO ./images/colorstone.xpm
SO ./images/wood.xpm
WE ./images/greystone.xpm
EA ./images/redbrick.xpm

F 220,100,10
C 225,30,10

        1111111111111111111111111
        1000000000110000000000001
        1011000001110000000000001
        1001000000000000000000001
111111111011000001110000000000001
100000000011000001110001111111111
10000000000000001101010010001
10000000000000001101010010001
11000000110101011100000010001
10000000000000001100000000001
10000000000000001101010010001
11000001110101011111011110N0111
11110111 1110101 101111010001
11111111 1111111 111111111111