NO ./images/colorstone.xpm
SO ./images/wood.xpm
WE ./images/greystone.xpm
EA ./images/redbrick.xpm

F 220,100,10
C 225,30,10

11111111
110000W1
10000001
10000001
10000001
10000001
10000001
11111111
