NO ./images/colorstone.xpm
SO ./images/wood.xpm
WE ./images/greystone.xpm
EA ./images/redbrick.xpm

F 179, 166, 55
C 117, 78, 46

11111111
11000001
10000001
10000001
10000001
10N00001
10000001
11111111
